02,02,02,02,02,02,02,02,02,02,02,02,02,02,02,02,02,02,02,02,02,02,02,02,02
02,07,05,05,05,05,05,05,05,05,05,05,05,05,05,05,05,05,05,05,05,05,05,06,02
02,09,04,04,18,04,04,04,04,04,04,18,04,04,04,18,04,04,04,04,04,04,04,17,02
02,09,04,04,04,04,04,04,04,04,03,03,03,03,03,04,04,04,04,13,04,04,18,17,02
02,09,04,04,04,04,04,13,04,01,02,02,02,02,02,08,03,04,04,04,04,04,04,17,02
02,09,04,18,04,04,04,04,01,02,02,02,02,02,02,02,02,09,04,04,04,04,04,17,02
02,09,04,04,04,04,04,01,02,12,02,15,15,02,02,02,02,08,13,04,04,18,04,17,02
02,09,04,04,04,04,17,02,02,02,02,02,15,02,02,12,02,02,09,04,04,04,04,17,02
02,09,04,13,04,04,17,02,02,15,15,15,15,15,15,02,02,02,09,04,04,04,04,17,02
02,09,04,04,04,04,17,02,02,15,15,15,15,15,15,02,02,02,10,03,04,13,04,17,02
02,09,04,04,04,04,01,02,02,02,02,15,15,15,15,02,02,02,02,02,08,04,04,17,02
02,09,13,04,04,01,02,12,02,15,02,02,02,02,15,15,15,15,02,02,02,09,04,17,02
02,09,04,04,01,02,02,02,02,02,02,02,02,02,02,15,02,15,02,12,02,09,04,17,02
02,09,04,17,02,15,15,15,02,02,07,06,02,02,02,02,02,02,02,02,07,04,18,17,02
02,09,04,17,02,02,15,15,02,07,04,04,06,02,02,02,02,02,07,05,04,04,04,17,02
02,09,04,04,16,02,02,02,07,04,18,04,04,06,02,02,02,07,13,04,04,04,04,17,02
02,09,13,04,04,05,05,05,04,04,04,13,04,04,05,05,05,04,04,04,04,04,18,17,02
02,09,13,18,04,18,04,13,04,04,13,04,04,04,04,18,04,04,04,18,04,04,04,17,02
02,08,03,03,03,03,03,03,03,03,03,03,03,03,03,03,03,03,03,03,03,03,03,01,02
02,02,02,02,02,02,02,02,02,02,02,02,02,02,02,02,02,02,02,02,02,02,02,02,02

1,1,1,1,1,1,1,1,1,1,1,1,1,1,1,1,1,1,1,1,1,1,1,1,1
1,0,0,0,0,0,0,0,0,0,0,0,0,0,0,0,0,0,0,0,0,0,0,0,1
1,0,0,0,1,0,0,0,0,0,0,1,0,0,0,1,0,0,0,0,0,0,0,0,1
1,0,0,0,0,0,0,0,0,0,0,0,0,0,0,0,0,0,0,1,0,0,1,0,1
1,0,0,0,0,0,0,1,0,0,0,0,0,0,0,0,0,0,0,0,0,0,0,0,1
1,0,0,1,0,0,0,0,0,0,0,0,0,0,0,0,0,0,0,0,0,0,0,0,1
1,0,0,0,0,0,0,0,0,1,0,1,1,0,0,0,0,0,1,0,0,1,0,0,1
1,0,0,0,0,0,0,0,0,0,0,0,1,0,0,1,0,0,0,0,0,0,0,0,1
1,0,0,1,0,0,0,0,0,1,1,1,1,1,1,0,0,0,0,0,0,0,0,0,1
1,0,0,0,0,0,0,0,0,1,1,1,1,1,1,0,0,0,1,0,0,1,0,0,1
1,0,0,0,0,0,0,0,0,0,0,1,1,1,1,0,0,0,0,0,0,0,0,0,1
1,0,1,0,0,0,0,1,0,1,0,0,0,0,1,1,1,1,0,0,0,0,0,0,1
1,0,0,0,0,0,0,0,0,0,0,0,0,0,0,1,0,1,0,1,0,0,0,0,1
1,0,0,0,0,1,1,1,0,0,0,0,0,0,0,0,0,0,0,0,0,0,1,0,1
1,0,0,0,0,0,1,1,0,0,0,0,0,0,0,0,0,0,0,0,0,0,0,0,1
1,0,0,0,1,0,0,0,0,0,1,0,0,0,0,0,0,0,1,0,0,0,0,0,1
1,0,1,0,0,0,0,0,0,0,0,1,0,0,0,0,0,0,0,0,0,0,1,0,1
1,0,1,1,0,1,0,1,0,0,1,0,0,0,0,1,0,0,0,1,0,0,0,0,1
1,0,0,0,0,0,0,0,0,0,0,0,0,0,0,0,0,0,0,0,0,0,0,0,1
1,1,1,1,1,1,1,1,1,1,1,1,1,1,1,1,1,1,1,1,1,1,1,1,1

